5x6
1m111
10001
11101
10001
10101
111e1