11x11
11111111111
10000010001
10100010101
e0100000101
10111111101
10101000101
10001110101
10111010101
101m1010001
10000010001
11111111111