10 25
1111111111111111111111111
1m000000000001000000001e1
1000000100000100000000001
1111111100000100000000001
1000000000000100000000001
1011111111111110111111111
1000100000000000000000001
1000111101111111011110111
1000000000001000000010001
1111111111111111111111111