10 10
1111111111
1000100011
1010111011
1000110001
1011110111
1000000001
1110101011
1100000001
1111111111
1111111111